R 1200 1200
NO ./texture/colorstone.XPM
SO ./texture/w o od.XPM    
WE ./texture/redbrick.XPM
EA ./texture/ bluestone.XPM
S ./texture/barrel.XPM

F 255,112,1
C 135,206,235


                    1
                   1N1
                111101111
                100200001
               11000100011
              1100010100111
              1002001020001
     111111111100200000000111111111111111111111111111111111111111111111111111
     10000000000000010000000000000000000000000000000000000000000000000000000111
     1011111111111001010011111111111111111111111011111111111110111111111111011
     101       11000100011                     101           101          101
     101        100000001                      101           101          101
     101        111101111111111111111111111111110111         101          101
     101           100000000000000000000000000000001      11110111        101
     10111111111111111111111100111111111011011111101      10000001        101
     1000000000000000000000000011      100001  111011111111011110111111111101
     11111111111111111110111111111111111000011110000000000001  10000000000001
                       10000000000000000000000000111111111111  11111111111111
                       11111111111111111111111111